0000000000000000000000000000000000000000000
0000000000000000000000000000000111111000000
0000000000000000000000000000000100000000000
0000000000000000000000000000000100000000000
0000000000000000000000000000000100000000000
0000000000000000000000000000000100000000000
0000000000000000000000000000000100000000000
0000000000001111000000000000111100000000000
0000000000000000000000000000000000000000000
0001000010000000000000011000000000000000000
1111111110000000001111111000000000000000000
0000000011111111111000001000000000000000000
0000000000000000000000001000000000000000000
0000000000000000000000001000000000000000000
0000000000000000000000001111111100000000000
0000000000000000000000000000000000000000000
0000000000000000000000000000000000000000000
0000000000000000000000000000000000000000000
0000000000000000000000000000000000000000000
0000000000000000000000000000000000000000000
0000000000000000000000000000000000000000000
0000000000000000000000000000000000000000000
0000000000000000000000000000000000000000000
0000000000000000000000000000000000000000000
0000000000000000000000000000000000000000000